4 4 4 4 4 4 4 4 4 4 4 4 4 4 4 4 4 4 4 4
4 4 4 4 4 4 4 4 4 4 4 4 4 4 4 4 4 4 4 4
4 4 4 4 4 4 4 4 z 4 4 4 4 4 4 4 4 4 4 4
4 4 4 4 4 4 4 4 z z z z z z z e 4 4 4 4
4 4 4 4 4 4 4 4 z z 4 4 4 4 4 4 4 4 4 4
4 4 4 4 4 z z z z 4 4 4 4 4 4 4 4 4 4 4
4 4 4 z k b p z 4 4 4 4 4 4 4 4 4 4 4 4
4 4 4 4 4 4 4 4 4 4 4 4 4 4 4 4 4 4 4 4
4 4 4 4 4 4 4 4 4 4 4 4 4 4 4 4 4 4 4 4
4 4 4 4 4 4 4 4 4 4 4 4 4 4 4 4 4 4 4 4
4 4 4 4 4 4 4 4 4 4 4 4 4 4 4 4 4 4 4 4
4 4 4 4 4 4 4 4 4 4 4 4 4 4 4 4 4 4 4 4