0 2 3 z q w 4 4 4 4 4 4 4 4 4 4 4 4 4 4
3 0 8 z a s 4 4 4 4 4 4 4 4 4 4 4 4 4 4
z z z p z e 4 4 4 4 4 4 4 4 4 4 4 4 4 4
0 z z w 2 q 4 4 4 4 4 4 4 4 4 4 4 4 4 4
1 1 1 1 1 1 4 4 4 4 4 4 4 4 4 4 4 4 4 4
4 4 4 4 4 4 4 4 4 4 4 4 4 4 4 4 4 4 4 4
4 4 4 4 4 4 4 4 4 4 4 4 4 4 4 4 4 4 4 4
4 4 4 4 4 4 4 4 4 4 4 4 4 4 4 4 4 4 4 4
4 4 4 4 4 4 4 4 4 4 4 4 4 4 4 4 4 4 4 4
4 4 4 4 4 4 4 4 4 4 4 4 4 4 4 4 4 4 4 4
4 4 4 4 4 4 4 4 4 4 4 4 4 4 4 4 4 4 4 4
4 4 4 4 4 4 4 4 4 4 4 4 4 4 4 4 4 4 4 4